Gloss	Jiamao language	Proto-Hlai
1sg	kaw¹	*ɦu:
1pl excl	ʔaw¹	*fʰəw
1pl incl	tej¹	*hrəw
2sg	məj¹	*C-mɯ:
2pl	tsʰaw¹	*sʰəw
3sg	nej⁵	*C-na:
3pl	mow⁵	*ɾu:ɦ
that (distal)	mɔ:⁵	*C-ma:ɦ
this (proximal)	nɛ:⁵	*C-ni:ɦ
that (medial)	kɛ:⁴	*ɦəɰɦ
one	kɯ:²	*tçʰɯ:
two	ɬiaw⁴	*hlu:ʔ
three	ta:w¹	*Cuʈʂhuʔ
four	tiəw¹	*ʈʂhəwʔ
five	pu:⁴	*hma:
six	nəm⁴	*hnom
seven	ɗaw¹	*tʰu:
eight	ku:¹	*hru:
nine	fə:¹	*C-wɯ:ʔ
ten	puət⁹	*fʰu:t
hundred	kɯ:n¹	*Cuhra:n
ancestor	pə:w⁴ tuən⁴	*pʰut pʰu:ʔ
woman	mɯ² ta:w¹	*hmi:ʔ kʰəwɦ
man	pʰɯ¹ tsə:⁴	*pʰa:ʔ C-ma:n
wife	na:w⁵	*kʰəwɦ
father’s younger sister	fi:⁴	*fʰɯ:ʔ
child	ɬiək⁸ lat⁷	*hlɯ:k C-lik
younger sibling	nuəj⁵	*hru:ŋ
face	pʰan¹	*ɗəŋ
ear	kɔ:¹	*hljəj
shoulder	vet¹⁰	*ʋa:ɦ
arm	tɯ:n¹	*kʰi:n
sweat	ʔɯat⁷	*Cuʔən
chin	tsʰɔ:ŋ¹	*ɦa:ŋ
throat	lɔ:k⁸	*kʰə:k
breast	ɲen⁵	*tçi:ɦ
lung	vuəŋ⁴	*kəwɦ
urine	tsem⁵	*ɗu:
horse	pə:⁵	*hŋa:ʔ
cat	ɲa:w⁵	*C-mi:wɦ
pangolin	tsa:⁴	*C-mɯnʔ
squirrel	lə:n⁵	*C-ɲa:t
crab	tsʰa:k⁹	*ɓu:ɦ
bird	nɔ:k⁹	*sʰəc
pig	pəj⁴	*hməw
monkey	nɔ:k⁹ tsʰa:ŋ¹	*C-nok
porcupine	lu:⁴ low²	*tçʰinʔ
bat	tʰiək⁷	*Cuhrɯ:k
shrimp	ʔɔ:⁵	*Cuɾa:ŋ
snake	ɓuət⁷	*hlja:ɦ
gadfly	nɯa⁵	*hlja:k
mosquito	tsʰak⁷	*C-ɲu:ŋ
beetle	pa:p⁸	*ɾa:p
bee	tej¹	*kə:j
moth	tsi:w⁴	*tʰəmʔ
bedbug	ɗɔ:p⁹	*kɯp
bamboo	ɓa:¹	*C-la:w
white sesame hemp	ven⁴	*kʰa:n
muskmelon	haŋ¹	*ʔəj
mushroom	tsʰaŋ¹	*ɗit
cotton	ɓɔk⁷ hɔ:w⁴	*ɦa:wʔ
pit (fruit)	hɯət⁷	*ʔu:k
sesame	tiaw⁴	*hŋɯ:
white rattan (small)	lej¹	*kəc
mat grass	lə:p⁷	*hrji:wʔ
coconut	pɔ:⁵ tsʰuək⁷	*Ciʔunɦ
flower	ŋɯa¹	*ʈʂha:ŋ
fruit	mɯat⁷	*ʈʂhə:m
chaff	vu:⁴ vit⁸	*hli:p
sky	vuəj¹	*fʰa:ʔ
hail	tsʰa:⁵	*sʰinɦ
wasteland	fa:²	*hmu:ŋ
mountain	tsow¹	*Cuɦəwʔ
ash	fa:¹	*sʰu:ʔ
star	tsap⁷tsin⁵	*ɾa:w
frost	nɔ:w⁴ vuəj¹	*hljin
forest	ŋuən⁵	*hrəŋ
typhoon	pʰa:ŋ¹	*hwənɦ
sand	ɗej¹	*pʰu:ɦ
house	ɬɯ:²	*hrɯ:n
animal pen	ŋat⁷	*sʰu:nɦ
bench	ŋuən¹	*tʰimɦ
cradle	ʔə:j¹	*ʔu:
bamboo hat	kuən³ lɔ:j⁵	*hla:ŋʔ
shoes	ləm⁵	*kə:mʔ
net (small)	piw¹	*hrə:jʔ
fan	pʰaŋ⁵	*hwoŋʔ
jar	lej⁵	*kəj
dagger	ɬiək⁸ kʰua¹	*hljiwʔ
child’s house	ɗɔ:¹	*kujʔ
trough	tɔ:ŋ¹	*[ʈʂ]hu:
mat	tsiək⁸	*tʰɯ:k
road	tin¹	*ku:n
earring	tsʰiaw¹	*hwi:ŋɦ
arrow	pe:¹	*sʰi:p
fish basket	ɓa:w¹	*C-li:k
vine basket	ɓi:n¹ lɔ:¹	*tçʰəwɦ
bowl/basin	la:k⁹	*Cuʔa:w
a handle (knife)	ɓuən¹	*fʰi:nʔ
black	tsʰej¹	*ɗəmʔ
yellow	tsaj⁴	*hlja:ŋ
salty	taŋ²	*Cuɦa:nʔ
good	maŋ¹	*hlin
old (thing)	ʔjɔ:t⁹	*ka:wʔ
early	puət⁸	*ka:wʔ
fast	tsʰiaŋ⁵	*hjinʔ
wide	vi:⁴	*ɓa:ŋ
hard	lə:w⁴	*tçʰə:nʔ
dense	ni:t⁹	*tʰi:t
live, fresh	ɬuət⁸	*Cuɾi:p
horizontal	ləŋ⁴	*ɾinɦ
blind	kʰiw¹	*m-la:w
beautiful	nɔk⁷	*hlin C-mɯ:n
hot	ʔjuŋ¹	*Cuʈʂhəwʔ
afraid	ɬɔ:⁴	*ɗa:ʔ
dry	kʰa:¹	*ɾa:nɦ
round	la:w¹	*Cuhrom
empty	kʰaŋ¹	*Cuɾajɦ
fine	ɲə:p⁸	*ʔu:t
grey	pʰu:¹	*hma:wɦ
indigo	ta:¹	*tçʰi:ŋ
spicy	kəŋ⁵	*hrit
bad	ʔaj¹	*ɾja:k
new	ɬaw⁴	*hma:n
late	liaw¹	*fʰəŋ
slow	tsəŋ²	*sʰi:ʔ
narrow	vi:n⁵	*ɓi:p
soft	puək⁷	*hmu:t
sparse	fuən¹	*hŋwa:nʔ
rotten	ɲɯ:t⁸	*ʔɯ:nʔ
vertical	tiam¹	*ɦən
lazy	lɯam²	*C-la:nʔ
young	mɯ² niaw¹	*hlɯ:k C-mɯ:n
cool (water)	ɓe:k⁷	*hrən
thin	ŋa:w¹	*C-li:ʔ
sterile (egg)	tsum¹ luəŋ²	*Cuhra:wʔ
few	tə:k⁸	*ɾjəwɦ
straight	kɯŋ⁵	*C-mu:c
do	leŋ¹	*ʋu:k
listen	ŋej²	*m-lɯ:
eat	tej⁵	*C-lu:ɦ
vomit	ʔɔŋ¹	*fʰa:k
bite	ɗa:n¹	*hŋa:ɲʔ
hit	təp⁸	*tʰa:jɦ
cut rice	pʰɯ:w¹	*tʰun
light fire	tu:⁵	*ʔɯmɦ
flow	lɔ:t⁸	*C-ma:w
take	mi:²	*hmət
kill	tse:²	*ɦu:ʔ
play	liaw¹	*hrjɯ:k
get	mɯən¹	*C-m[e]:k
answer	hɔ:n⁴	*tʰin
fall	ʔa:⁵	*hla:ɦ
weave (net)	tsʰa:¹	*kʰu:t
understand	min⁴ taj²	*kʰu:ŋ
look	maj¹	*kiw
swallow	kuat¹⁰	*Ciʔə:mɦ
lick	ɬe:p⁸	*hlji:mɦ
hold in mouth	tɔm⁵	*fʰə:m
cast (seed)	ʔia¹	*fʰə:nɦ
winnow	vat⁷	*fʰənɦ
boil	puət⁸	*ɗa:n
swim	lɔn¹	*m-li:
pick up	kʰɛ:⁵ lə:w⁴	*tçʰi:wʔ
call	kow⁴	*tça:n
arrive	vow¹	*ɗa:nʔ
give	mɯan¹	*ɗɯ:
die	lɔ:t⁹	*hla:wɦ; *hlju:j
braid (large)	ta:¹	*m-li:
weave (fabric)	tsʰup⁷	*hwi:
top	law¹law¹	*pʰi:ʔ hnɯ:
front	pʰa:j⁵ tʰiəŋ⁴	*pʰi:ʔ ɗəŋ
side	pʰa:j⁵	*fʰa:ŋ
left	haj² huəj⁴	*pʰi:ʔ hwi:ŋ
everywhere	vow¹ la:j⁴	*hŋom hŋa:jʔ
inside	tsʰu:¹ ke:⁴	*pʰi:ʔ ʔu:k
outside	lɔ:w⁴	*hljɯ:n
opposite side	ʔe:k⁹	*hlɯnɦ
right	pʰa:j⁵ pet¹⁰	*pʰi:ʔ hninɦ
2 years ago	mɯ² lut¹⁰	*hmu:ɦ ɾɯ:
2 days ago	vɔ:n¹ tsu:n⁴	*hwən ɾɯ:
from before	tsʰi¹ vɔ:n¹ mɔ:⁵	*tçʰi kʰu:nɦ
last year	mɯ² lə:j⁴	*hmu:ɦ pʰənʔ
next year	ma:¹ tʰiəŋ⁴	*hmu:ɦ ɗəŋ
3 days later	kɯ² kut¹⁰	*hwən Cuɦa:t
2 days later	kɯ² ka:²	*hwən Cuɦɯ:
morning	ziaw⁴ hɔm⁴	*ka:wʔ ɗom
noon	kɯ² ɗuən⁵	*ʈʂha: hŋwən
trip clf.	lem¹	*ku:n
pile clf.	ɓa:k⁹	*C-le:p
land measure	hɯan¹	*tçʰa:n
person clf.	ŋuən¹	*tçu:n
bundle clf.	puək⁹	*ɓi:k
layer	fɯ:n⁴	*hlɯt
piece (of)	ɗat⁷	*tʰun
tree clf.	nɔ:w⁵	*kʰɯ:ŋɦ
needle clf.	tsʰin⁵	*tçʰu:ŋ
pile clf.	tsu:n⁵	*pʰəwʔ
speech clf.	tuəŋ⁵	*fʰa:k
long thing clf.	tɯj¹	*Ciɦa:ɦ
pair (of)	ʔum¹	*hlɯ:mC
