English gloss	Proto-Mjuenic	Pre-Mjuenic
angle, corner	*klɔŋ A1	*klɔŋ A
ant	*dzʰiəu B1	*dzʰiəu B
arrive	*tʰau C1	*tʰəu C
arrow	*fɔŋ A1	*fɔŋ A
ascend	*faːu C1	*fau C
ashes	*swaːi B1	*swai B
ask	*naːi C2	*nai C
axe	*pou B1	*pou B
bag	*buəʔ D2	*mbuək D
bag	*ti C2	*di C
bamboo	*hlau B1	*hləu B
bamboo tube	*doŋ A2	*ndoŋ A
banana	*ts̪iu A1	*ts̪iu A
bangle	*tɕjam A2	*dʑjəm A
bark (v.)	*dʑuŋ C1	*ʔdʑuŋ C
bark, husk, shell	*kʰuʔ D1	*kʰuk D
barn	*ɣam B2	*rəm B
beans, peas	*top D2	*dop D
bear (animal)	*kliəp D1	*kliəp D
beat	*bɔʔ D1	*ʔbɔk D
bee	*muəi B2	*muəi B
beeswax	*dʐiŋ A1	*ʔdʐiŋ A
bent, crooked	*ŋau A1	*ʔŋəu A
big, large	*hlo A1	*hlo A
bird	*nɔʔ D2	*nɔk D
bitter	*ʔim A1	*ʔim A
black	*klaʔ D1	*klək D
blanket	*ɕwɔŋ C1	*ɕwɔŋ C
blood	*dzʰjaːm B1	*dzʰjam B
blow	*plɔm B1	*plɔm B
blow (of the wind)	*pwan C2	*bwən C
board	*pen B1	*pen B
boat	*dʐʰaːŋ B1	*dʐʰaŋ B
body	*sin A1	*sin A
boil, cook	*tsou B1	*tsou B
boiling	*bwei C1	*ʔbwei C
bone	*sbuŋ B1	*sʔbuŋ B
book	*sou A1	*sou A
borrow	*kaː B1	*ka B
bow	*hnaː B1	*hna B
bowl (for porridge)	*wjan B1	*ʔwjən B
box	*hlwap D1	*hlwəp D
branch	*gwaː A2	*ŋgwa A
break	*ʔaːu B1	*ʔau B
breast, milk	*nju C1/B1	*nʔju C/B
burn	*puə B1	*puə B
bury, extinguish (a fire)	*plop D1	*plop D
buy	*maːi B2	*mai B
cage	*loŋ A2	*loŋ A
carry	*pou A2	*bou A
carry (on shoulder)	*daːm A1	*ʔdam A
centipede	*ɕwap D1	*ɕwəp D
chair	*ʔei B1	*ʔei B
chicken	*kjai A1	*kjəi A
child	*tɕwei B1	*tɕwei B
choose	*kjen B1	*kjen B
clear	*dʐʰaŋ A1	*dʐʰəŋ A
close	*maʔ D2	*mək D
cloth	*diə A1	*ʔdiə A
cloud	*buən C1	*ʔbuən C
cold	*tɕwaŋ B1	*tɕwəŋ B
comb	*tsaʔ D1	*tsək D
come	*taːi A2	*da A
cool	*nam C1	*ʔnəm C
core	*fim A1	*fim A
cough	*-haː A1	*-ha A
cover	*gom B1	*ʔgom B
cry, weep	*ŋiəm B1	*ʔŋiəm B
cut (with scissors)	*klap D1	*kləp D
cut down (a tree)	*kɔi C1	*kɔi C
day, sun	*hnɔi A1	*hnɔi A
deer (animal)	*kjuŋ A1	*kjuŋ A
deep	*do A1	*ʔdo A
defeated	*ɕwei A1	*ɕwei A
delicious	*kʰu B1	*kʰu B
descend	*dʑjaː C2	*ndʑja C
die	*tai C2	*dəi C
dig	*wet D1	*ʔwet D
dog	*klo B1	*klo B
door	*klɛŋ A2	*glɛŋ A
dove	*go A1	*ʔgo A
dream	*bei C1	*ʔbei C
drink	*hop D1	*hop D
drug	*diə A1	*ʔdiə A
dry (v.)	*pʰwaːi A1	*pʰwai A
duck	*ʔaːp D1	*ʔap D
dung, excrement	*-ai B1	*-əi B
dye	*ɲom C2	*ɲom C
ear	*-nɔm A2	*-nɔm A
earth	*hniə A1	*hniə A
eat	*ŋjan C2	*ŋjən C
egg	*klau C1	*kləu C
eight	*-jat D2	*-jət D
enter	*pjaʔ D2	*bjək D
evening	*ɣuŋ A2 giəm C1	*ruŋ A ʔgiəm C
exit	*tɕʰwat D1	*tɕʰwət D
eye	*muəi C2	*muəi C
face	*hmiən A1	*hmiən A
fall	*tui A2	*dui A
far	*ko A1	*ko A
fat	*klun C2	*glun C
fat, lard	*hmei A1	*hmei A
fear, frightened	*-dzjaː B2	*-ndzja B
fertilizer	*pwan C1	*pwən C
finger, toe	*-doʔ D1	*-ʔdok D
fire	*tou B2	*dou B
firewood	*tʂaːŋ A2	*dʐaŋ A
fish	*blau B2	*mbləu B
five	*plaː A1	*pla A
flesh, meat	*ʔwaː B1	*ʔwa B
float	*biəu A2	*mbiəu A
flower	*pjwaŋ A2	*pjwəŋ A
fly (v.)	*dʰai C1	*dʰəi C
fly (housefly)	*mwoŋ B2	*mwoŋ B
forehead	*plɔŋ A2	*blɔŋ A
forest	*klem A2	*glem A
forget	*-kʰwoʔ D1	*-kʰwok D
four	*plei A1	*plei A
frog	*kjɛŋ B1	*kjɛŋ B
frost	*ɕɔŋ A1	*ɕɔŋ A
fruit	*piəu B1	*piəu B
full	*pwɔŋ B1	*pwɔŋ B
garment (upper)	*ɣui A1	*ʔrui A
get stuck (in the throat)	*kaː B2	*ga B
get up	*kwiə B2	*gwiə B
ghost, spirit	*mjwan B1	*mʔjwən B
ginger	*ɕuŋ A1	*ɕuŋ A
girl	*sjaʔ D1	*sjək D
give	*pwun A1	*pwun A
go	*mniŋ A2	*mniŋ A
goat, sheep	*juŋ A2	*juŋ A
gold	*tɕjam A1	*tɕjəm A
good	*ɣwɔŋ C1	*ʔrwɔŋ C
goose	*ŋjaː A2	*ŋja A
grandchild	*fun A1	*fun A
grass	*mʰjwaː B1	*mʰjwa B
green	*mɛŋ A1	*ʔmɛŋ A
gun	*tsʰwɔŋ D2	*tsʰwɔŋ D
hail	*plɔʔ A1	*blɔk A
hair (body)	*plei B2	*plei B
hand	*puə B2	*buə B
handle	*pɛŋ C1	*pɛŋ C
hard	*ŋɛŋ C2	*ŋɛŋ C
have	*mnaːi A2	*mnai A
he, she	*njan A2	*njən A
head	*plei B1	*plei B
heavy	*hniə B1	*hniə B
high, tall	*hɣaŋ A1	*hrəŋ A
hole	*kʰwot D1	*kʰwot D
horn	*klɔŋ A1	*klɔŋ A
horse	*maː B2	*ma B
hot (taste)	*bjaːt D2	*mbjat D
hot, warm	*klɔm A1	*klɔm A
house	*plau B1	*pləu B
human being, person	*mjuən A2	*mjuən A
hundred	*pɛʔ D1	*pɛk D
I	*jaː A1	*ʔja A
insect	*klɛŋ A1	*klɛŋ A
insert	*ts̪ʰip D1	*ts̪ʰip D
intestines	*klaːŋ A2	*glaŋ A
intoxicated	*gwin A1	*ʔgwin A
iron	*hɣjaʔ D1	*hrjək D
itchy	*sjat D1	*sjət D
jump	*tʰiu C1	*tʰiu C
keep	*piŋ C1	*piŋ C
keep food (for somebody)	*ɣiəu A2	*riəu A
kick	*dʰiʔ D1	*dʰik D
kill	*tai C1	*təi C
king	*hu A2	*guŋ A  > *ɣuŋ A > *ɦuŋ A
kneel	*kuəi C2	*guəi C
know	*pei A1	*pei A
lamp	*twaŋ A1	*twəŋ A
land leech	*pjwom A1	*pjʔwom A
laugh	*klat D1	*klət D
lazy	*lwei C2	*lwei C
leaf	*nɔm A2	*nɔm A
leak	*fui C1	*fui C
left side	*ts̪aːi C1	*ts̪ai C
leg	*ts̪au C1	*ts̪əu C
let go, set free	*puŋ C1	*puŋ C
lick	*biə C2	*mbiə C
lick	*klem B2	*glem B
lid	*gaːi C1	*ʔgai C
life	*mɛŋ C2	*mɛŋ C
lift (one’s head)	*ŋɔŋ B2	*ŋɔŋ B
lightweight	*heŋ A1	*heŋ A
lightweight	*ɕiəu A1	*ɕiəu A
liquor	*tiu B1	*tiu B
listen	*mʰwaŋ C1	*mʰwəŋ C
liver	*hɣan A1	*hrən A
long (length)	*daːu B1	*ʔdau B
long (time)	*lau A2	*ləu A
look at	*mwaŋ C2	*mwəŋ C
look for	*lɔ B2	*lɔ B
loud	*bʰui A1	*bʰui A
louse	*dz̪ʰei B1	*dz̪ʰei B
lungs	*pʰlom A1	*pʰlom A
mat	*tsiʔ D2	*dzik D
melt	*juʔ D2	*juk D
mix	*kwap D1	*kwəp D
monkey	*biŋ A1	*ʔbiŋ A
moon	*hlaː C1	*hla C
mortar	*tɔi C1	*tɔi C
mountain	*tsɔŋ A1	*tsɔŋ A
moustache	*sjwaːm A1	*sjʰwam A
nail (finger)	*gwai C1	*ʔgwəi C
name	*buə C1	*ʔbuə C
narrow	*hep D2	*gep D > *ɣep D > *ɦep D
navel	*ndut D1	*nʔdut D
near	*fat D1	*fət D
neck	*klaːŋ A1	*klaŋ A
needle	*ɕim A1	*ɕim A
new	*sjaŋ A1	*sjəŋ A
news, letter	*fjen C1	*fjen C
nine	*duə A2	*nduə A
old	*ko C1	*ko C
open, spread	*kʰɔi A1	*kʰɔi A
otter	*tsʰaːt D1	*tsʰat D
paddy field	*ɣiŋ A2	*riŋ A
pain	*mun A1	*ʔmun A
palm (hand)	*tswaːŋ B1	*tswaŋ B
peel	*mɛʔ D1	*ʔmɛk D
penis	*klai C1	*kləi C
pig	*tuŋ B2	*duŋ B
pillar	*ton A1	*ton A
place across	*kjaː C1	*kja C
plough	*ɣai A2	*rəi A
point (v.)	*nuʔ D1	*ʔnuk D
pot	*tsʰɛŋ A1	*tsʰɛŋ A
potato, yam	*dɔi A2	*ndɔi A
prepare	*ben C2	*mben C
present (v.), send somebody off	*fuŋ C1	*fuŋ C
press, squeeze	*njan B1	*ʔnjən B
pull out	*pɛŋ A1	*pɛŋ A
pus	*noŋ C2	*noŋ C
rain	*bluŋ C2	*mbluŋ C
rat	*naːu B2	*nau B
rat	*duʔ D1	*ʔduk D
read	*twoʔ D2	*dwok D
red	*ɕiʔ D1	*ɕik D
rice (cooked)	*hnaːŋ C1	*hnaŋ C
rice (milled)	*hmei B1	*hmei B
rice (plant)	*blau A2	*mbləu A
rice (unmilled)	*tsʰuʔ D1	*tsʰuk D
right hand	*bjaːu C2	*mbjau C
ripe, well-cooked	*tswoʔ D2	*dzwok D
road	*klau B1	*kləu B
round	*klun A2	*glun A
salt	*dʐau B1	*ʔdʐəu B
scented	*daːŋ A1	*ʔdaŋ A
scissors	*dʑeu B1	*ʔdʑeu B
scratch	*ɲaːi B1	*ɲai B
sea	*kʰɔi B1	*kʰɔi B
sectional division	*hɣem C1	*hrem C
see	*pwat D2	*bwət D
sell	*maːi C2	*mai C
separate	*ɣei A2	*rei A
sesame	*ɕaʔ D1	*ɕək D
seven	*ɲi C1/C2	*(ʔ)ɲi C
sew	*ɣwon A2	*rwon A
shade	*glom C1	*ʔglom C
shadow	*klɔi A1	*klɔi A
shake	*ŋaːu A2	*ŋau A
sharp	*ɣai C2	*rəi C
shoot	*pwan B1	*pwən B
shop	*pʰou C1	*pʰou C
short (height)	*haː C1	*ha C
short (length)	*hn-ŋ B1	*hn-ŋ B
shrimp	*kʰjaː A1	*kʰja A
silk	*fei A1	*fei A
silver	*ɲaːn A2	*ɲan A
sit	*ts̪wei B2	*dz̪wei B
six	*kluʔ D1	*kluk D
skin	*dop D1	*ʔdop D
sky	*ɣuŋ A2	*ruŋ A
sleep	*pwei C1	*pwei C
sleeping	*gjɔm A2	*ŋgjɔm A
slippery	*blaːŋ C2	*mblaŋ C
slow	*blaː B2	*mbla B
smell	*hnom B1	*hnom B
smoke (n.)	*ɕiəu C1	*ɕiəu C
snail (water)	*kuəi A1	*kuəi A
snake	*naːŋ A1	*ʔnaŋ A
snot	*blut D2	*mblut D
socks	*mat D2	*mət D
son	*twɔn A1	*twɔn A
son-in-law	*laːŋ A2	*laŋ A
sour	*sui A1	*sui A
speech	*waː C2	*wa C
spur (of a cock)	*tɕiəu B2	*dʑiəu B
stairs	*tʰei A1	*tʰei A
stand	*spi B1	*spi B
star	*hɣei C1	*hrei C
stay	*jam A1	*ʔjəm A
stay still, stop	*tiŋ A2	*diŋ A
steal	*nim C2	*nim C
stick	*pjaː B1	*pja B
sting	*tan C1	*tən C
stink	*ts̪wei C1	*ts̪wei C
stone, rock	*ɣau A1	*ʔrəu A
stoop	*doʔ D1	*ʔdok D
story	*kou B1	*kou B
stove	*lou A2	*lou A
stump	*kwɔn A1	*kwɔn A
sweat	*haːn C2	*ɦan C
sweet	*kaːm A1	*kam A
tail	*twei B1	*twei B
take	*tsoʔ D1	*tsok D
taro	*hou C2	*gou C > *ɣou C > *ɦou C
teach	*dʑaːu C1	*ʔdʑau C
ten	*tʂjap D2	*dʐjəp D
thick	*ho B2	*go B > *ɣo B > *ɦo B
thin	*klai C2	*gləi C
thorn	*dʑim B1	*ʔdʑim B
thousand	*ts̪ʰin A1	*ts̪ʰin A
thread	*sui C1	*sui C
three	*puə A1	*puə A
tie	*sai A1	*səi A
tie (turban)	*peu A1	*peu A
tiptoe	*ndjeŋ C1	*nʔdjeŋ C
tred	*kʰwɔn C1	*kʰwɔn C
tongue	*bliət D2	*mbliət D
tooth	*ɲaː A2	*ɲa A
tortoise	*to C2	*do C
tree, wood	*djaŋ C1	*ʔdjəŋ C
trousers	*kʰwaː C1	*kʰwa C
turn (one’s head)	*hwin A1	*hwin A
two	*ʔui A1	*ʔui A
under	*-diə B1	*-ʔdiə B
urine	*wjaː B2	*wja B
use	*nloŋ C2	*nloŋ C
vagina	*tiət D1	*tiət D
vegetable	*ɣai A1	*ʔrəi A
village	*ɣaːŋ B2	*raŋ B
vomit	*ʔo B1	*ʔo B
wait	*tsuə B1	*tsuə B
warm (v.)	*hɲut D1	*hɲut D
wash	*dʐaːu C1	*ʔdʐzu C
wash (clothes)	*dʐʰo C1	*dʐʰo C
water	*ʔwam A1	*ʔwəm A
weave (basket)	*tʂjaʔ D1	*tʂjək D
weave (cloth)	*dat D1	*ʔdət D
wet	*dɔn A1	*ʔdɔn A
white	*pɛʔ D2	*bɛk D
wide	*kjwaŋ B1	*kjʔwəŋ B
wife	*ʔau B1	*ʔəu B
win	*hiŋ A2	*ɦiŋ A
wind	*dzjaːu C1	*ʔdzjau C
wing	*daːt D1	*ʔdat D
wipe off	*swɔt D1	*swɔt D
write	*fiə B1	*fiə B
year	*hɲaŋ C1	*hɲəŋ C
yellow	*wjaŋ A2	*wjəŋ A
you	*mwei A2	*mwei A
young	*ɣun C1	*ʔrun C
