Proto-Ainu	Accent pattern	Gloss	Notes	Page
*a=d[E]=hdan=		“seven”	(lit. “three-ten”)	77
*a[t/C]=dus	H-L	“a kind of cloth”		*
*aa		“to sit” (sing.)		
*aa-nE	HL-L	“to be thin (and round)”		
*aatya	LLH	“father”		
*ad		“to assemble”		
*agi	LL	“arrow”		
*agu	LL	“tongue”		
*agu=	LH	“to enter”		
*ak	L	“younger brother”		
*am	L	“fingernail”		
*ama	LH	“to take off”		*
*amurnin	LHL	“(fore)arm”		
*an=, *a=		“I”	(folklore texts)	
*an		“to be born”		
*an		“to be, to exist, to dwell” (sing.)		
*an=	L	“to hold (in one’s arms)”		
*an		“night”		
*anun	LH	“stranger, outsider”		
*apa	LL	“doorway”		
*apE (<*apOy ?)	LH	“fire”		
*apkas	HL	“to walk”		*
*aptO	HL	“rain”		
*aqu	HL	“next, neighbour”		
*ar(=)tE (*ar=dE ?)	H-L	“to hang (it)”		
*arka	HL	“painful, sore, hurting”		
*arki	HL	“to come” (plur.)		
*as		“to stand (up)” (sing.)		
*as=i	L-H	“to close (it)”		
*asir	LH	“to be new”		
*askay	HL	“to be skillful, to be able”		
*askE	HL	“hand”		*
*aski	HL	“five”	(*asik LH)	
*asnap	HL	“paddle”		
*at		“w:Ulmus laciniata” (“elm tree”)		
*atu	LH	“to vomit”		
*atusa	LLH	“naked, bare”		
*atuy	LL	“sea”		
*atya	(accent pattern is not clear)	“uncle”		
*ay	L	“thorn”	(< *agi LL if related to *agi “arrow”)	
*aykap	HL	“to be unskillful, to be unable”		
*aynu	HL	“person, man (in general)”	(< *a(n)=inu ?)	*
*Am=a (<*Am=u)	L-H	“to put (it)” (sing.)		
*Am=dE		“to put (it)” (plur.)		
*Am(=)Am	L(-)H	“rice”		
*Ap	L	“ice drift”		
*AsAm	LL	“bottom, depths”		
*At	L	“string, cord”		
*daarak	HLL	“smooth”		
*day	H	“to die”		*
*dE=		“three”		
*dEE	HL	“name”		
*dEEra	HLL	“wind”		
*dE=kut	L-L	“neck”		
*dE(=)tar	L(-)H	“white”		
*du=p	L	“ice”		
*dus	L	“skin, fur”		
*E=	L	“you” (sing.)		*
*E=ak	L-H	“to shoot”		
*E=kan=hOk	L-H-L	“to go out to meet a person on his way”		
*E(=)qEn (*E(=)gEn ?)	L(-)H	“to be sharp-pointed”		
*E=rusa	L-LH	“to lend, to loan”		
*E=si(=)kar(=)un	L-L(-)H(-)L	“to recall (it), to remember (it), to recollect (it)”		
*E=siina	L-LLH	“to conceal, to keep secret”		
*E=sOO		“to borrow”		
*E=tay=	L-L	“to pull”		*
*E(=)tin(=)kE	LHL	“tortoise”		
*E=tun	L-H	“to borrow”		
*EE		“to eat (it)”		
*Eg		“to come” (sing.)		
*Ekasi (*Ekagi/*Ekahi ?)	LLH	“old man, grandfather”		
*EmkO	HL	“half”		
*Emus	LL	“sword”		
*Epa	LH	“to arrive, to reach”		
*Epir[V]	LL[L]	“knife”		
*Epuy	LH	“sprout, bud, flower”		
*ErEkus (*erekus ?)	LLH	“cod fish”		*
*Erum	HH	“mouse”		
*Esaman	LLH	“otter”		
*Esna	HL	“sneeze”		
*Eti=	LL	“you” (plur.)		
*EtOp	LL	“hair”		
*Etu	LL	“nose”		
*ga=ita		“not enough, lacking”		
*gaa(=)pO	HH(-)L	“mother”	(*=pO may be a suffix)	
*gaatir	HLL	“to fall (down)”		*
*gan=kE	H-L	“to be near”		
*gAnku	HL	“navel”		
*gaqu	LL	“voice”		
*gar=ke	H-L	“left”		
*=gayta	HL	“to make a mistake”		
*gEEsE	HLL	“to breathe”		
*gEm=an=ta (*hEmanta ?)	L-H-L	“what”		
*gEm=pa=ra		“when”		
*gEm=pak=pE		“how many”		
*gik/*gek		“to be born”		*
*gik(=)nu (*sik(=)nu/*hik(=)nu ?)	H-L	“to be alive, to live”		
*gik(=)up (*sik(=)up/*hik(=)up ?)	L-H	“to grow up”		
*gita	LH	“dog”	(< *LL ? cf. accent in KK)	
*gOk		“to buy”		
*gOm		“knot, joint (of bamboo)”		
*gOn	L	“belly, stomach”		
*gOOr=nE		“to be loose”		
*gop=nE	H-L	“to be narrow”		
*gOqinu	LHL	“marten”		*
*gOr(=)ka	H(-)L	“to be inverted, to be upside down”		
*gOr(=)kEqu	H(=)LL	“wolf”		
*gOr=sE	H-L	“to rot, to decay, rotten”		
*gOs(=)ki=	H(-)L	“before, previous”		
*gOt		“twenty”		
*gOt=kE	H-L	“to lie down”		
*gOtku	HL	“to stoop”		
*gu	H	“to be living (of a plant)”		
*gum	L	“sound, noise”		
*gun(=)pE	H(-)L	“whale”		*
*gun=pa		“to chop (it), to mince (it)”		
*gunAr=	LL	“to seek (it), to look for”		
*gu[n]na	HL	“who”		
*gup	L	“to swell, swelling”		
*gur	H	“mountain, hill”		
*gura	HH	“smell”		
*gurti	HL	“old woman, grandmother”		
*guskO	HL	“to be old”		
*guu		“to be raw, to be fresh”		
•guurE	HLL	“red”		
*guy (? *huy)	L	“cheek of the fish”		*
*hapur	LH	“to be weak, to be soft”		
*haram	LH	“lizard”		
*hayOk=pE	LH-L	“armour”		
*hdak=ka	HL	“water”		
*hdan=	H	“ten”		
*hdatara	LLH	“stone, cliff”		
*hdEn		“to be bad”		
*hdOO		“span of the thumb and first finger”		
*hEkati	LLH	“child”		
*h[E/e]ma(=)ka (*g[E/e]ma(=)ka ?)	LH(-)L	“to end”		*
*hEmOy	LH	“trout”		
*hEpEr	LH	“bear cub”		
*hErOki	LLH	“herring”		
*hO		“pubic area” (?)		
*hO(=)rip=	L(-)H/L(-)L (?)	“to dance”		
*hO(=)rOp[=sE]	LH[-L]	“to sip (loudly)”		
*hO=kus	L-H	“to fall”		
*hO=pun=i	L-L-H	“to fly, to get up” (sing.)		
*hO=pun=pa	L-H-L	“to fly, to get up” (plur.)		
*hO=ra=k	L-H	“to fall”	(from hO= + ra “down, under” + =k)	
*hO=sip= (*hO=gip=/*hO=hip= ?)	L-L	“to come/go home”		*
*hO=yup=	L-L	“to run”		
*hOku	LL	“husband”		
*hOma (*gOma ?)	LH	“spawn”		
*hOmar	LH	“to be vague, to be faint”		
*hOtuy=	LL	“to call, to shout”		
*hrA=	L	“leaf”		
*hrup	H	“(white) fir, coniferous tree”		*
*hur		“bamboo grass”		
*Ham	L	“claw”		
*Haspa	HL	“deaf”		
*HE(=)sE	HL	“to consent to, to comply with”		
*HOn=tarO (*Hon=taro ?)	H-LL	“barrel”	(< J taru “barrel”)	
*Hupsi (*Hupgi/*Huphi ?)	HL	“lacquer”	(? < J urusi “lacquer”)	
*Huurar	HLL	“fog”		
*i=Ak(=)a		“to show, to point to”		
*i=Ak=u	L-L-H	“to crash, to smash”		
*i=As=	L	“to tear (it), to split (it)”		*
*i=EE	L-HL	“to say (it)”		
*i=kasma	L-HL	“to be in excess, to remain, to be left over”		
*i=kOn=i	L-L-H	“to fall (seriously) ill”		
*i=n[u]=kar	H-(L)-L	“to be seen”		
*i=nuu	L-LH	“to be heard”		
*i=On=i	L-L-H	“to draw (it) back, to withdraw”		
*i=up=	L-L	“to tighten (it)”		
*ii=hdan=		“six”	(lit “four-ten”)	*
*ii=nE=	HL-L	“four”		
*ihdagu		“sulphur”		
*ihka	HL	“to steal”		
*ik	H	“waist”		
*ik		“hundred”		
*ik	L	“joint (of bamboo)”		
*ik=maqu=re	H-LL-L	“belch”		
*ikus(=)pE	LH(-)L	“pillar”		
*ima(=)k	L(-)L	“tooth”		
*imEru	LLH	“lightning”		
*imO(=)k	LH	“earthworm”		*
*imOka	LLH	“present, gift”		
*in[a]=	L[L]	“which”		
*inaqu		“to perform inau ritual”		
*inon(=)pE	LH(-)L	“frame of a fireplace”		
*ipOr (*ipOd ?)	LL	“color”		
*ir=nE	H-L	“many (of people)”		
*irOr=nE (*irOt=nE ?)	LH-L	“to be thick (and flat)”		
*iqEE	LHL	“pus”		
*is	L	“bird's tail”		
*isEpO	LLH	“hare”		
*ita	LH	“board”	(< J ita “board”)	
*ita(=)k	LL	“language, word, to speak, to talk”		*
*itanki	LHL	“wooden bowl”		
*ityaniqu		“trout”		
*ka	L	“on, above”	(J ue)	
*kaa	HL	“cord, thread, yarn”		
*kaa		“trap”		
*kaani	HHH	“metal”	(< OJ kane HH)	
*kaari=p	LLL	“wheel, ring, hoop”		
*kaasi=qu	HHL-L	“to help”		
*kakka	LH	“vulva”		*
*kam	L	“meat”		
*kamuy	LH	“god”	(< OJ kamiy or PJ *kamu=i “god”)	
*kankan	HL	“intestines”		
*kantO	HL	“heaven, sky”		
*kAp	L	“skin, fur”	(? < OJ kaFa or PJ *kapa)	
*kap=ar	L-H	“to be thin (and flat)”		
*kapa(=)p	LH	“bat”		
*kapiqu	LHL	“seagull”		
*kaqu=kaqu		“sleet, hail”		
*kar (< *kii=yar ?)		“to make”		
*kar		“to peel (it)”		*
*kar		“to pick, to nip, to pluck”		
*kar=	L	“to roll over, to turn around”		
*karku	HL	“nephew”		
*karus	LH	“mushroom”		
*kasup	LH	“ladle”		
*kay	L	“to break (of a long thing)”	(*kay=i L-H “to break a long thing”)	
*kay		“to carry piggyback”		
*kaya	LH	“sail”		
*kEE		“oil (as food), fat”		*
*kEE[qu]	HL[L]	“to shave (it), to whittle (it), to plane (it)”		
*kEEra	HLL	“taste”		
*kEm	L	“blood”		
*kEm		“to lick”		
*kem	L	“needle”		
*kEma	LL	“foot, leg”		
*kEn (*ken ?)	L	“sprout, bud”		
*kEqu (*kequ ?)		“uncle, elder male relative”		
*kEqu		“bone”		
*ker	L	“footwear”		
*kE=s	L	“end”		*
*kEs=		“every”		
*kEsup (*kesup ?)	LL	“heel”		
*kEta	LH	“star”		
*ki		“louse”		
*ki		“reed”		
*kii		“to do”		
*kiiki	LLH	“to scratch (it)”	(< *kii=kii ?)	
*kik		“to hit, to beat”		*
*kiki(=)r	LH	“worm, insect, bug”		
*kim		“mountain”		
*kina	LH	“(edible) grass”		
*kip=utur	L-LH	“forehead”		
*kir	L	“marrow”		
*kira	LH	“to run away, to flee”		
*ki(=)raqu	LLH	“horn”		
*kiray	LL	“comb”		
•kirOr (*kiror ?)	LH (LL ?)	“strength”		
*kirpu	HL	“fat, grease”		
*kisAr	LL	“ear”		*
*kisma	HL	“to seize, to catch”		
*kitay	LH	“roof”		
*kitay	LH	“summit, peak”		
*kïr=u	L-H	“to turn (it) toward”		
*kO=kO	L-L	“son-in-law, elder sister's husband”		
*kO(=)s	H	“daughter-in-law, elder brother's wife”		
*kO=r	L	“to have”		*
*kO[O]=C=dE	L[L]-H	“to give”	(lit. “to make have”)	
*kOkka	HL	“knee”		
*kOm (*kom ?)		“oak”		
*kOmta (*komta ?)		“elbow”		
*kOn=sum	HL	“foam, bubble”		
*kOnti	HL	“hat”		
*kOs=nE	H-L	“to be light (not heavy)”		
*kO=sun=kE	L-H-L	“to deceive”		
*kOt	L	“traces, marks”		
*kOt=		“front, before”		*
*kOtan	LL	“village, country”		
*kOy		“wave”		
*koy	L	“urine”		
*kOy(=)ki	H(-)L	“to tease, to torment, to scold, to hunt”		
*köt=	L	“to tie (it) to, to fasten (it) to”		
*ku=	L	“I”		
*kuhda	LH	“cane, walking stick”		
*kuma	LH	“(bamboo) pole”		*
*kumi	LL	“mold”		
*kunki	LH	“nail”	(< J kugi “nail”)	
*kup	H	“shoulder”		
*kupa	LH	“to bite”		
*kur	L	“shadow”		
*kur		“person, man (in general)”		
*kur=	H	“black”	(? < OJ kurwo= “black”)	
*kurki	HL	“gills”		
*kus		“to pass, to go through”		
*kut	L	“waistband, belt”		*
*kuta	LH	“to spill (it)”		
*kutyan	LH	“female bear”		
*kuu	LH	“bow”		
*kuu		“to drink (it)”		
*kuy		“to chew”		
*kuy(=)tO=p	HL	“wild goose”		
*ma=k	H	“inside”		
*maa		“to roast”		
*maa		“to swim”		*
*makiri	LLH	“knife”		
*maqu=s=Ok	HL-L	“yawn”		
*mat	L	“woman, wife”		
*mata	LL	“winter”		
*mE(=)k/*mi(=)k		“to bark”		
*mEE=		“to be cold”		
*mës=	L	“to pick, to nip, to pluck”		
*mës=	L	“to peel (it)”		
*mii		“to put on clothes”		*
*miina	HLL	“to laugh”		
*mim	L	“meat (of fish)”		
*mit		“grandchild”		
*miti	HL	“father”		
*mO	L (?)	“world, land, island, country” (?)		
*mO	L	“sleep”		
*mO(=)yuk	L(-)H	“tanuki, raccoon dog”		
*mOm		“to flow”		
*mOn (*mon ?)		“hand”		
*mOn(=)rE	H(-)L	“to be late (at night), to come late, to be slow”		*
*mOs	L	“a fly”		
*mOsma	HL	“other (than), besides, (anything) else”		
*mOy (*moy ?)		“eddy, whirlpool”		
*mOy		“inlet, bay”		
*mOy=		“to move, to be in motion”		
*mOyO	LH	“few, little”		
*m[r]Ak=	H	“to open (it)”		
*mukar	LH	“axe”		*
*mukku	HL	“flute, pipe”		
*mun		“(inedible) grass”		
*mun		“trash, rubbish”		
*munin	LH	“to rot, to decay, rotten”		
*muy		“winnow”	(< PJ *mui)	
*na(=)ni	L(-)H	“at once, immediately”		
*nAn	L	“face”		
*naqa	LH	“still”		
*nata	LH	“hatchet”	(< J nata “hatchet”)	*
*nay		“stream, river”		
*nEE=	LH	“who, what”		
*nEskO	HL	“walnut tree”		
*nEtO	LH	“calm, lull”		
*nii		“to sip”		
*nii		“tooth”		
*nii		“tree”		
*nii(=)num	HL(-)L	“(wal)nut”	(lit. “tree's fruit” ?)	
*niisu	HLL	“mortar, handmill”		
*nimara	LLH	“half, part (of something)”		*
*nin		“to decrease, to diminish”		
*nin=	L	“to drag”		
*nis	H	“sky, cloud”		
*nis=	L	“to be strong, to be hard”		
*nis=	L	“to draw (water), to ladle, to dip”		
*nisap	LL	“shin”		
*nis(=)at	L(-)H	“dawn”		
*nispa	HL	“rich man”		*
*nit	L	“handle”		
*nïn=u	L-H	“to sew”		
*nOk	L	“testicles, egg”		
*nOka	LL	“picture, drawing, form, shape”		
*nOkO	LH	“saw”	(< J noko=giri “saw”)	
*nOn	L	“saliva”		
*nOna	LH	“sea urchin, sea chestnut”		
*nOOti(=)qu		“star”		
*nOqi=pE	HLL	“brain”		
*nOrnO	HL	“flower”		*
*nOrnO/*narna		“mother”		
*nOs=ki	H-L	“middle, center”		
*nOs=pa	H-L	“to pursue, to chase”		
*nOt	H	“chin, jaw”		
*nOtAk	LH	“cutting edge”		
*nOy=		“temple”		
*nöm(=)i	H(-)H	“to hold a festival, to perform memorial duties”		
*nöy=	L	“to twist”		*
*nu		“to ask”		
nu=kar	L-H	“to see, to look at”		
*num	L	“fruit, berry, to bear fruit”		
*num	L	“grain, granule, ball”		
*num=	L	“to squeeze”		
*num=kE	H-L	“to choose (it), to select (it)”		
*numa	LL	“hair”		
*nun=pE	H-L	“paste, glue”		
*nup		“field”		*
*nup(=)ki	H(-)L	“to get muddy”		
*nupEk	LL	“light”		
*nupuri	LLH	“mountain”	(< ? OJ no̱bo̱r=i HH-H)	
*nuu	HL	“eye”		
*nuu		“to hear, to listen”		
*nuuman	HLL	“yesterday”		
*nuy=kar	H-L	“to comb”		
*nuyna (<*nu=ina ?)		“to hide (it), to conceal (it)”		
*nüy=	L	“to carve (it)”		*
*nüy=	L	“to sweep”		
*opas	LH	“snow”		
*opsOr	HH	“bosom”		
*O(=)man=dE	L-H-L	“to present, to make a present”		
*O=kE=dE	L-L-H	“to end”		
*O=kEqu=	L-LH	“to expel, to drive out, to throw out”		
*O=sur=a	L-L-H	“to throw away”		
*Oga	LH	“to be empty”		*
*Ogak	LH	“to be shallow”		
*Ogaqu	LLH	“soup, broth”		
*OgOO	LHL	“to be deep”		
*Ok	H	“nape, the back of the neck”		
*Okay	LH	“to be, to exist, to dwell” (plur.)		
*Okkay(O)	HL(L)	“man, male”		
*Om	L	“thigh”		
*Om=kE	HL	“to cough”		
*Oma(=)p	LH	“to love, to like”		*
*Oman	LH	“to go” (sing.)		
*OmonpE	LHL	“pants”	(J o=monpe “(women's) skirt pantaloons”)	
*Ona (*ona ?)	LH	“father”		
*Onkami	HLL	“to worship”	(< NJ oNgamï “to worship”)	
*Onra	HL	“to forget (it)”		
*OO		“to ride (it)”		
*Op	L	“spear”		
*Opit(=)ta/*Opir=ta	LH-L	“all”		
*Or	L	“inside”	(J naka)	
*Or=nE	H-L	“to be old (of age)”		
*Os=kE	H-L	“to knit, to weave”		*
*Osma=k	HL	“back, behind”		
*OsOr	LL	“buttocks”		
*Ot=kE	H-L	“to poke (it)”		
*Ota	LH	“sand”		
*Oya=	LH	“after, next”		
*Oyaqu	LHL	“snake”		
*paa	HL	“steam, smoke”		*
*pa	L	“head”		
*paa	HL	“year, age”		
*pa[a]=qikar	HLL	“spring”		
*paa		“to find (it)”		
*paakari	HLLL	“to measure (it), to weigh (it)”	(< MJ Fakar-i LL-L)	
*paar=aC=sE		“to fly”		
*paasE	HLL	“to be heavy”		
*pAr=	H	“to fan”		
*para=ki	LL-H	“tick”		*
*pAs	L	“charcoal, cinders”		
*pas(=)kur	H(-)L	“crow”		
*pa[s]na	LH	“dust, dirt”		
*pasuy	LL	“chopsticks”	(< PJ *pasui)	
*patEk (*patek ?)	LH	“only”		
*pay=i	L-H	“to go” (plur.)		
*pE	H	“sap, water”		
*pEqurE	HLL	“to be young”		
*pEkEr	HL	“to be bright, to be light”		
*pEr=	L	“to break or split (it) in two or pieces”		
*pEra	LH	“(rice) paddle”	(< EMJ Fera “spatula, (rice) paddle, scoop”)	
*pEray	LH	“to fish with a line” (?)		
*pEt		“river”		
*=pEt		“finger”		
*pët=u	L-H	“to cut, to split”		
*pii		“seed”		
*piir=nE	HL-L	“male”		
*pir	L	“wound”		
*pir(=)ka	H(-)L	“to be good”		
*pirAs(=)a	LL(-)H	“to spread (it) out”		*
*pis	H	“seashore”		
*pis=ki (< *pis=kii ?)	H-L	“to count”		
*pisaku	LLH	“dipper”	(< MJ Fisaku “ladle”)	
*pisE	LH	“stomach”		
*pisi	LH	“to ask”		
*pita	LH	“to untie (it)”		
*=pitüy=	LH	“to push”		
*pïr=	L	“to wipe”		
*pOk	L	“vulva”		
*pOn		“to be small”		*
*ponE	LL	“bone”	(< PJ *pone LL “bone”)	
*pOO	HL	“son, child”		
*pOp	H	“sweat”		
*pOp		“to boil, to grow hot”		
*pOqina		“stone”		
*pOqOn	LH	“four” (?)		
*pOrO	LH	“to be big”		
*pOru	HL	“cave”	(< ? MJ Fora HH)	
*praa	HH	“edge”		
*praak	HH	“to teach, to inform”		
*pran		“light, thin, insipid (colour, taste)”		*
*prAA=	L	“mouth”		
*pras		“to run”		
*prO=k	L	“under, beneath, below”	(J sita)	
*pukuru	LLH	“bag”	(< OJ pukurwo “bag”)	
*punkar	HL	“vine”		
*puri	HH	“custom”	(< OJ Furi “custom”)	
*puta	LH	“cover, lid”	(< OJ Futa “lid”)	*
*puu	HL	“storehouse”		
*puy	L	“hole”		
*puyar/*puqar	LH	“window”		
*ra (*da ?)	H	“liver”		
*ra	H	“down”	(J sita=no kata)	
*ra= (*da= ?)		“to get clear”		
*raa(=)ra[a]y= (*daara[a]y=/*daa(=)da[a]y ?)	HLL	“to rub gently, to soothe”		
*raanu= (*daanu= ?)	HLL	“to love, to like”		*
*rak		“to smell”		
*rakkO (*dakkO ?)	HL	“sea otter”		
*rAm	L	“soul, heart, mind”		
*ram		“to be low”		
*rAm=rAm	H-L	“scales”		
*ranma (*danma ?)	HL	“always, usually”		
*rAr	L	“eyebrow”		
*rat (? *dat)	L	“phlegm”		
*rayonti	LLH	“rainbow”		
*rEk		“to sing, to cry (of a bird)”		*
*rE=n (*dE=n ?)		“to sink”		
*rEp (*dEp ?)	H	“offshore”		
*rEqu= (*dEqu= ?)	LL	“to bend (it)”		
*rEqus(=)i (*dEqu[g/h](=)i ?)	HL(-)L	“to stay (overnight)”		
*rEs= (*dEs= ?)	L	“to bring up, to rear”		
*rEy= (*dEy= ?)	LH	“to creep, to crawl”		
*ri (*di ?)	H	“to skin, to strip”		
*rik(=)an (*dik(=)an ?)	LH	“to be damp, to get damp”		
*rika (*dika ?)	LH	“whale('s meat)”		*
*rim=sE (*dim=sE ?)	H-L	“to dance”		
*rir (*dir ?)		“wave”		
*ris= (*dis= ?)		“to pick, to nip, to pluck”		
*=rit		“root”		
*rOk (*dOk ?)		“to sit” (plur.)		
*rOr=nu (*dOr=no/*rOr=no/*dOr=nu ?)	H-L	“to kill” (plur.)		
*rOs=ki	HL	“to stand (up)” (plur.)		
*ru (*du ?)	L	“traces, marks”		
*rup	L	“shoal”	(*dup ?)	
*ruqE/*rugE (*duqE/*dugE ?)	LH	“to be thick (and round)”		*
*rur (*dur ?)	L	“soup, broth”		
*rur (*dur ?)		“the tide”		
*rur=nu (*dur=nu ?)	H-L	“to be salty”		
*rura (*dura ?)	HL	“to see off”		
*rus(=)ka (*dus(=)ka ?)	H(-)L	“to get angry”		
*ruu (*duu ?)		“to melt”		
*ruura (*duura ?)	HLL	“to carry”		
*ruy (*duy ?)		“whetstone”		
*ruy=ruy= (*duy=duy= ?)	H	“to rub gently, to soothe”		
*ruyka/*requka (*duyka/*dequka ?)	HL/HLL	“bridge”		
*rük= (*dük= ?)	L	“to gulp down”		*
*sa	H	“elder sister”		
*sa	H	“head”		
*sa=		“to be non-existent”		
*sa=		“to come/go out”	(J deru)	
*sak	L	“summer”		
*sak=i	L-L	“trout”		
*sAm	L	“side”		*
*san=pE	H-L	“heart” (only as anatomical organ)		
*sAr	L	“tail”		
*sar		“field of reeds”		
*sara	LH	“to appear, to come out”		
*sAs		“sea-tangle, kelp”		
*sat	H	“to dry, to be dry”		
*say	L	“flock”		
*sE	H	“throat”		
*sEE		“to carry on the back”		
*sEEsEk	HLL	“to grow hot, to be hot”		
*sEm		“closet”		*
*sEnpir	HL	“behind, shade”		
*sEp		“to be broad”		
*sEt	L	“bed”		
*sEt	L	“nest”		
*sEtur	LL	“back”		
*sEy	L	“shell(fish)”		
*si(=)yuk (*gi(=)yuk/*hi(=)yuk ?)	H(-)L	“male bear”		
*si=nE= (*gi=nE=/*hi=nE= ?)	LH	“one”		
*si=nE=pE=hdan=		“nine”	(lit. “one-ten”)	
*sii (*gii ?)		“dung, fecal matter”	(cf. o=so=ma “to void feces”)	*
*sii (*gii/*hii ?)	HL	“right”		
*sii=n[e/i] (*gii=n[e/i]/*hii=n[e/i] ?)	LL-H	“to rest”		
*sii=sAm (*gii=sam/*hii=sam ?)	HLL	“foreigner”	(< sii “self” + sAm “side” ?)	
*sik (*gik/*hik ?)		“to be full”		
*sik(*gik/*hik ?)	L	“eye”		
*sik(=)kEqu	H(-)LL	“corner, edge, nook”		
*sikay/*tikay	LH	“wooden nail”		
*sin=ki (*gin=ki/*hin=ki ?)	H-L	“to get tired”		*
*sinma/*siima		“tomorrow”		
*sinOt (*ginOt/*hinOt ?)	LH	“game, to play”		
*si(=)ntOkO	H(-)LL	“container”		
*si(=)pOp	L(-)H	“box, case”	(*gipOp/*hipOp ?)	
*sippO	HL	“salt”	(< OJ sipo “salt”)	
*sipuya (*gipuya/*hipuya ?)	LLH	“smoke”		
*siqu		“to be bitter”		
*siqunin (*giqunin/*hiqunin ?)	HLL	“blue, green”		
*sir (*gir/*hir ?)		“weather”		
*sir (*gir/*hir ?)		“world, land, island, country”		*
*siraqu (*giraqu/*hiraqu ?)	LHL	“horsefly, gadfly”		
*sirar	LH (*girar/*hirar ?)	“rock”		
*sirma (*girma/*hirma ?)	HL	“dust, dirt”		
*sirnay (*girnay/*hirnay ?)	HL	“to change”		
*sirtOk (*girtOk/*hirtOk ?)	HL	“elbow”		
*si(=)tay=ki	L(-)H-L	“to weave”		
*sitOma	LLH	“to be afraid of”	(*gitOma/*hitOma ?)	
*sïn(=)a (*gïn(=)a/*hïn(=)a ?)	L(-)H	“to bind (it), to tie (it) up”		
*sïr=u (*gir=u/*hir=u ?)	H-H (?)	“to rub”		
*sO		“waterfall”		*
*sOk(=)kar	H(-)L	“mat, rug”		
*sOn=nO	H-L	“indeed, really, truly”		
*sOnkO	HL	“news, information”		
*sOs=	L	“to tear (it), to split (it)”		
*sOy		“outside”	(J soto)	
*sOya	LH	“bee, wasp”		
*su(=)gE (*su(=)qE ?)	L(-)H	“to cook, to boil”		
*su(=)kE	L(-)H	“to cook, to prepare”		
*su(=)su	L(-)H	“willow”		
*sum	L	“oil (as food)”		*
*sum		“to droop, to wither”		
*suma	LH	“stone”		
*sumari	LHL	“fox”		
*sun(=)kE	HL	“lie, to tell a lie”		
*sunE	(accent is not clear)	“light, torch”		
*sunku	HL	“silver fir”		
*sura	LH	“to release, to let go”		
*surku	HL	“poison”		
*suu		“pan”		
*suy	L	“hole”		
*süy=i	L-H	“to swing” (intr.), “to sway”		
*süy=i	H-H	“to shake, to wave”		*
*ta=	L	“now”		
*ta=	L	“this”		
*tAk	L	“lump, clod”		
*tak		“to invite”		
*tak		“to be short”		
*takar	LH	“dream”		
*tantO	HL	“today”	(< *ta “this” + an “to be” + tOO “day”)	
*tap	L	“shoulder, upper arm”		
*tar=nE	H-L	“to be long”		*
*tarap	LH	“dream”		
*tas[p]a=dE	LL	“to change (it), to exchange (it)”		
*tasum	LH	“to fall ill, to get sick”		
*tay=ki	HL	“flea”		
*tE(=)k	L	“hand, arm”		
*tEErE	HLL	“to wait for”		
*tEm		“fathom”		
*tEpa	LL	“loincloth”		
*tEr=kE	HL	“to jump”		
*tEy=nE		“to get wet”		*
*ti=	L	“bird”		
*ti=	L	“we”		
*tii	HL	“to wither”		
*tii	LH	“penis”		
*tii		“ripe, to grow ripe”		
*tii		“to be cooked, to be done, to be roasted”		
*tikir	LH (*ti=kir ?)	“foot, leg”		
*tiku=	LL	“tree”		
*tin	H	“waist”		
*tinita	LLH	“dream”		
*tinki	HL	“skirt, bottom”		
*tip	L	“canoe”		*
*tiqa=tiqa		“fox”		
*tiqar=	LL	“to scatter”		
*tiqasi (*tiqagi/*tiqahi ?)	HLL	“fence”		
*tiqEp	LL	“fish”		
*tiqu	LL	“tide”		
*tiqu		“to stab (it), to pierce (it)”		
*tiqu(=)p		“the sun, the moon, month”		
*tis		“to cry, to weep”		
*tisE	LH	“house”		
*tO=	L	“that”		*
*tOkkOni	HLL	“snake”		
*tOkkuri	HLL	“jug, bottle”	(< J tokkuri “bottle”, EMJ tokuri(go) “sake bottle”)	
*tOma	LH	“sweet potato, taro”		
*tOn(=)rE	H(-)L	“to get wet”		
*tOntO	HL	“processed leather”		
*tOO		“day”		
*tOO[C]	HH	“breasts (of woman)”		
*tOO		“lake”		
*tOOpEn	HLL	“sweet”		
*tOp		“bamboo”		
*tOpa	LL	“flock, herd”		
*tOy		“earth, soil, ground, land”		*
*top(=)sE	H(-)L	“to spit”		
*trAp	L	“feather”		
*trEk	L	“beard”		
*tri[i]=k		“up(per part)”	(J ue=no kata)	
*trii		“to be high”		
*truu		“road”		
*tu		“ridge (of a mountain), summit”		
*tuu=		“two”		
*tu=pE=hdan=		“eight”	(lit. “two-ten”)	*
*tuk	H	“to bud, to put forth buds or shoots”		
*=tuk=	L	“to come out, to grow”	(probably related to *tuk H)	
*tukan	LH	“to shoot”		
*tukar	LH	“seal”		
*tum	L	“strength”		
*tumAm	LL	“trunk (of the body), waist”		
*tumi	LH	“battle, war”		
*tunsir	HL	“grave”		
*tuntu	HL	“pillar, stake”		
*tup		“to move (to another place)”		*
*tur	L	“dirt”		
*tur=		“oak”		
*tura	LH	“to be accompanied by, to bring some-body”		
*turEp	LH	“sweet potato”		
*turi	(accent pattern is not clear)	“pole (for boats)”		
*tus	L	“rope”		
*tusa	LH	“to recover, to get cured”		
*tusa	LL	“sleeve”		
*tusu	LL	“shaman, shamanism”		
*tuuki	HLL	“sake cup”	(< OJ tukyi “sake cup”)	
*tuunas	HLL	“to be early, to be quick”		
*tuuti	LLH	“large wooden hammer”	(< MJ tuti “hammer”)	*
*tuy	L	“belly, intestines”		
*tuyma	HL	“to be far”		
*tür=	H	“to lengthen, to extend”		
*tüy	L	“to be cut”	(*tüy=i L-H)	
*=tya[qu]		“birthmark, mole”		
*tyuk	L	“fall”		
*tyOrtya		“to shoot (from the bow), to hit (the mark)”		
*u=pak=dE	L-H-L	“to compare”		*
*=[u]g	L	“place, spot”		
*ug		“to take, to receive” (sing.)		
*ug=ina	H-LL	“to take, to receive” (plur.)		
*uguy	LH	“to burn”		
*uku	LH	“to blow”		
*unar(=)pE	LH(-)L	“aunt”		
*unti	HL	“fire”		
*unu	LH	“mother”		
*upar	LH	“soot”		
*uqeeti (*ugeeti ?)		“chilblains”		
*ur	L	“fur coat”		*
*uray	LH	“stake”		
*urE	LL	“foot”		
*us		“to go out, to die out (of a fire)”		
*us		“to put on (trousers or shoes)”		
*us(=)i (*ug(=)i/*uh(=)i ?)	L(-)H	“to smear (it), to daub (it)”		
*usEy	HL	“hot water”		
*usis (*ugis/*uhis ?)	LH	“hoof”		
*ussi=qu (*uCgi=qu/*uChi=qu ?)	HLL	“servant”		
*ut	L	“rib”		
*utap=kE	LH-L	“to patch (up)”		*
*utur	LL	“between, interval, space”		
*uu[y]na	HLL	“ash, ashes”		
*=ür=	L	“to dig (it)”		
*ya	H	“dry land, the shore”		
*ya(=)ki	(accent pattern is not clear)	“cicada”		
*yaa		“net”		
*yam		“chestnut”		
*yar(=)pE	H(-)L	“diaper”		*
*yOmkor	HL	“hiccup”		
*yOspE (*yospe/*yOspe/*yospE ?)	HL	“stomach”		
*yuk		“reindeer”		
*yuk(=)ki	H(-)L	“tick”		
*yup	H	“elder brother”		
*yuukar	HLL	“epic song”		154
